111111111111111111
1C100000C110000C01
10000C00000010110111
1P000000C10011E001
111111111111111111
